..........W.........
A...W....###........
+++++++...1.........
..........W......S..
C...W.....W......###
+++++++...W.........
..........W.........
..C.W.....W.........
+++++++...W..W....C.
..........W..+++++++
...CW.....W.........
+++++++...W..W.....C
..........W..+++++++
.....X....W.........
..@@@@@@@@@@@@@@@@..
Six levels of hot flames...
3000
