....................
...................R
####^^^^^^^^^^^^^^..
....................
r...................
..^^^^^^^^^^^^^^^^##
....................
...................R
##^^^^^^^^^^^^^^^^..
....................
r...................
..^^^^^^^^^^^^^^^^##
....................
........X....W....1.
####################
Red tiles are hot and reduce the time before you explode.
30
