#....X...................................................#
.....------------------------------------------------.....
.....------------------------------------------------.....
.....------------------------------------------------.....
.....------------------------------------------------.....
.....------------------------------------------------.....
.....------------------------------------------------.....
.....------------------------------------------------.....
.....------------------------------------------------.....
.....------------------------------------------------.....
.....------------------------------------------------.....
.....------------------------------------------------.....
.....------------------------------------------------.....
..........................................................
..........CCCCC..CCCCC...CCCCC...CCCCC...CCCCC............
.....------------------------------------------------.....
.....------------------------------------------------.....
.r.r.------------------------------------------------..R.R
.r.r.------------------------------------------------..R.R
.r.r.------------------------------------------------..R.R
.r.r.------------------------------------------------..R.R
.r.r.------------------------------------------------..R.R
.r.r.------------------------------------------------..R.R
.r.r.------------------------------------------------..R.R
.r.r.------------------------------------------------..R.R
.r.r.------------------------------------------------..R.R
.r.r.------------------------------------------------..R.R
.r.r.------------------------------------------------..R.R
.r.r.------------------------------------------------..R.R
.r.r.------------------------------------------------..R.R
.r.r.------------------------------------------------..R.R
.r.r.------------------------------------------------..R.R
.r.r.------------------------------------------------..R.R
.r.r.------------------------------------------------..R.R
.r.r.------------------------------------------------..R.R
.r.r.------------------------------------------------..R.R
.r.r.------------------------------------------------..R.R
.r.r.------------------------------------------------..R.R
.r.r.------------------------------------------------..R.R
.r.r.------------------------------------------------..R.R
.r.r.------------------------------------------------..R.R
.r.r.------------------------------------------------..R.R
.r.r.------------------------------------------------..R.R
.r.r.------------------------------------------------..R.R
.r.r.------------------------------------------------..R.R
.r.r.------------------------------------------------..R.R
.r.r.------------------------------------------------..R.R
.r.r.------------------------------------------------..R.R
.r.r.------------------------------------------------..R.R
.r.r.------------------------------------------------..R.R
.r.r.------------------------------------------------..R.R
.r.r.------------------------------------------------..R.R
.r.r.------------------------------------------------..R.R
.r.r.------------------------------------------------..R.R
.r.r.------------------------------------------------..R.R
.r.r.------------------------------------------------..R.R
.r.r.------------------------------------------------..R.R
.r.r.------------------------------------------------..R.R
.r.r.------------------------------------------------..R.R
.r.r.------------------------------------------------..R.R
.r.r.------------------------------------------------..R.R
.r.r.------------------------------------------------..R.R
.r.r.------------------------------------------------..R.R
.r.r.------------------------------------------------..R.R
.r.r.------------------------------------------------..R.R
.r.r.------------------------------------------------..R.R
.r.r.------------------------------------------------..R.R
.r.r.------------------------------------------------..R.R
.....------------------------------------------------.....
..........................................................
.....------------------------------------------------.....
.1........................................................
********************************************************..
..........................................................
..........................................................
....................................................W.##..
....................................................##....
I'm a fish, are you?
3600
