#....X...................................................#
.....------------------------------------------------.....
.....------------------------------------------------.....
.....------------------------------------------------.....
.....------------------------------------------------.....
.....------------------------------------------------.....
.....------------------------------------------------.....
.....------------------------------------------------.....
.....------------------------------------------------.....
.....------------------------------------------------.....
.....------------------------------------------------.....
.....------------------------------------------------.....
.....------------------------------------------------.....
..........................................................
..........AAAAA..AAAAA...AAAAA...AAAAA...AAAAA............
.....------------------------------------------------.....
.....------------------------------------------------.....
.r...------------------------------------------------....R
.r.r.------------------------------------------------..R.R
.r...------------------------------------------------....R
.r.r.------------------------------------------------..R.R
.r...------------------------------------------------....R
.r.r.------------------------------------------------..R.R
.r...------------------------------------------------....R
.r.r.------------------------------------------------..R.R
.r...------------------------------------------------....R
.r.r.------------------------------------------------..R.R
.r...------------------------------------------------....R
.r.r.------------------------------------------------..R.R
.r...------------------------------------------------....R
.r.r.------------------------------------------------..R.R
.r...------------------------------------------------....R
.r.r.------------------------------------------------..R.R
.r...------------------------------------------------....R
.r.r.------------------------------------------------..R.R
.r...------------------------------------------------....R
.r.r.------------------------------------------------..R.R
.r...------------------------------------------------....R
.r.r.------------------------------------------------..R.R
.r...------------------------------------------------....R
.r.r.------------------------------------------------..R.R
.r...------------------------------------------------....R
.r.r.------------------------------------------------..R.R
.r...------------------------------------------------....R
.r.r.------------------------------------------------..R.R
.r...------------------------------------------------....R
.r.r.------------------------------------------------..R.R
.r...------------------------------------------------....R
.r.r.------------------------------------------------..R.R
.r...------------------------------------------------....R
.r.r.------------------------------------------------..R.R
.r...------------------------------------------------....R
.r.r.------------------------------------------------..R.R
.r...------------------------------------------------....R
.r.r.------------------------------------------------..R.R
.r...------------------------------------------------....R
.r.r.------------------------------------------------..R.R
.r...------------------------------------------------....R
.r.r.------------------------------------------------..R.R
.r...------------------------------------------------....R
.r.r.------------------------------------------------..R.R
.r...------------------------------------------------....R
.r.r.------------------------------------------------..R.R
.r...------------------------------------------------....R
.r.r.------------------------------------------------..R.R
.r...------------------------------------------------....R
.r.r.------------------------------------------------..R.R
.r...------------------------------------------------....R
.....------------------------------------------------.....
..........................................................
.....------------------------------------------------.....
.1........................................................
********************************************************..
..........................................................
..........................................................
....................................................W.##..
....................................................##....
I'm a fish, are you?
3600
