..........W........R
A...W....###........
+++++++...1.........
r.........W......S..
C...W.....W......###
+++++++...W.........
..........W........R
..C.W.....W.........
+++++++...W..W....C.
..........W..+++++++
r..CW.....W.........
+++++++...W..W.....C
..........W..+++++++
.....X....W........R
..@@@@@@@@@@@@@@@@..
Six levels of hot flames...
30
