......................
.......W....W.........
***...................
......***..***........
1..................X..
****............****..
......................
W.W.W..........W.W.W..
*****..........*****..
......................
W.W.W..........W.W.W..
******........******..
......................
...W.W........W.W.....
...****......****.....
Watch out, the ice is slippery!
120